**********
*o      **
*** * ?  E
***   *  *
** *  * **
***  ** **
*** *   **
**      **
**     ***
**********