**********
*o      **
*** *    E
***   *  *
** *  * **
***  ** **
*** *   **
**  ?   **
**     ***
**********